NO ./textures/N.xpm
SO ./textures/S.xpm
WE ./textures/W.xpm
EA ./textures/E.xpm

F 220,100,0
C 225, 225, 200
111111111111111
1N0000000000 11
100010001000001
100000000010001
1    0000000001
11111  11111  1
1    0000011111
1  1  1     001
10000 000000001
100000000000001
100000000011111
11111111111111
