WE ./textures/W.xpm
NO ./textures/N.xpm
SO ./textures/S.xpm
EA ./textures/E.xpm

C 128,128,255
F 112,80,64

111111111
1     001
1 000 0 1
1 0 000 1
1 00   01
1  0 0 01
1 00 0001
100 0 0 1
10  0 0 1
1000000 1
1    0 01
1N0000001
111111111